#########
###.....#
#.#.###.#
#.#.#...#
@.#.###.i
#...###.#
##..#...#
#########
