###########
####.....##
##.#.###.##
##.#.###.##
#@.#.###.i#
##.#.###.##
##...#...##
###########
