###########
####.....##
##.#.###.##
##.#.#...##
#@.......i#
##...###.##
###..#...##
###########
